702
325 325 325 325 325 325 325 325 325 325 326 326 326 326 326 326 326 326 326 326 326 326 326 325 325 325 325 325 325 325 325 325 325 325 325 325 325 325  00
325 325 325 325 325 325 325 325 325 325 326 330 332 332 332 332 332 332 332 332 332 334 326 325 325 325 325 325 325 325 325 325 325 325 325 325 325 325  00
325 325 325 325 325 325 325 325 325 325 326 330 332 332 332 332 332 332 332 332 332 334 326 325 325 325 325 325 325 325 325 325 325 325 325 325 325 325  00
325 325 325 325 325 325 325 325 325 325 326 335 336 336 336 332 332 332 336 336 336 337 326 325 325 325 325 325 325 325 325 325 325 325 325 325 325 325  00
325 325 325 325 325 325 325 325 325 325 325 326 326 326 326 330 332 334 326 326 326 326 325 325 325 325 325 325 325 325 325 325 325 325 325 325 325 325  00
325 325 325 325 325 325 325 325 325 325 325 325 325 325 326 330 332 334 326 325 325 325 325 325 325 325 325 325 325 325 325 325 325 325 325 325 325 325  00
325 325 325 325 325 325 325 325 325 325 325 325 325 325 326 330 332 334 326 325 325 325 325 325 325 325 325 325 325 325 325 325 325 325 325 325 325 325  00
325 325 325 325 325 325 325 325 325 325 325 326 326 326 326 330 332 334 326 325 325 325 325 325 325 325 325 325 325 325 325 325 325 325 325 325 325 325  00
325 325 325 325 325 325 325 325 325 325 326 329 331 331 331 332 332 334 326 325 325 325 325 325 325 325 325 325 325 325 325 325 325 325 325 325 325 325  00
325 325 325 325 325 325 325 325 325 325 326 330 332 332 332 332 332 334 326 325 325 325 325 325 325 325 325 325 325 325 325 325 325 325 325 325 325 325  00
325 325 325 325 325 325 325 325 325 325 326 335 336 336 336 332 332 334 326 326 326 326 325 325 325 325 325 325 325 325 325 325 325 325 325 325 325 325  00
325 325 325 325 325 325 325 325 325 325 325 326 326 326 326 330 332 332 331 331 331 333 326 325 325 325 325 325 325 325 325 325 325 325 325 325 325 325  00
325 325 325 325 325 325 325 325 325 325 325 325 325 325 326 330 332 332 332 332 332 334 326 325 325 325 325 325 325 325 325 325 325 325 325 325 325 325  00
325 325 325 325 325 325 325 325 325 325 325 325 325 325 326 330 332 332 336 336 336 337 326 325 325 325 325 325 325 325 325 325 325 325 325 325 325 325  00
325 325 325 325 325 325 325 325 325 325 325 325 325 325 326 330 332 334 326 326 326 326 325 325 325 325 325 325 325 325 325 325 325 325 325 325 325 325  00
325 325 325 325 325 325 325 325 325 325 325 325 325 325 326 330 332 334 326 325 325 325 325 325 325 325 325 325 325 325 325 325 325 325 325 325 325 325  00
325 325 325 325 325 325 325 325 325 325 325 325 325 325 326 330 332 334 326 325 325 325 325 325 325 325 325 325 325 325 325 325 325 325 325 325 325 325  00
325 325 325 325 325 325 325 325 325 325 325 325 325 325 326 325 332 325 325 325 325 325 325 325 325 325 325 325 325 325 325 325 325 325 325 325 325 325  00