702
325 325 325 325 325 325 325 325 325 325 326 326 326 326 326 326 326 326 326 326 326 326 326 325 325 325 325 325 325 325 325 325 325 325 325 325 325 325  00
325 325 325 325 325 325 325 325 325 325 326 325 325 325 325 325 013 325 325 325 325 325 326 325 325 325 325 325 325 325 325 325 325 325 325 325 325 325  00
325 325 325 325 325 325 325 325 325 325 326 325 325 325 325 325 325 325 325 325 325 325 326 325 325 325 325 325 325 325 325 325 325 325 325 325 325 325  00
325 325 325 325 325 325 325 325 325 325 326 325 325 325 325 325 325 325 325 325 325 325 326 325 325 325 325 325 325 325 325 325 325 325 325 325 325 325  00
325 325 325 325 325 325 325 325 325 325 325 326 326 326 326 011 325 325 326 326 326 326 325 325 325 325 325 325 325 325 325 325 325 325 325 325 325 325  00
325 325 325 325 325 325 325 325 325 325 325 325 325 325 326 325 325 325 326 325 325 325 325 325 325 325 325 325 325 325 325 325 325 325 325 325 325 325  00
325 325 325 325 325 325 325 325 325 325 325 325 325 325 326 325 325 325 326 325 325 325 325 325 325 325 325 325 325 325 325 325 325 325 325 325 325 325  00
325 325 325 325 325 325 325 325 325 325 325 326 326 326 326 325 325 012 326 325 325 325 325 325 325 325 325 325 325 325 325 325 325 325 325 325 325 325  00
325 325 325 325 325 325 325 325 325 325 326 325 325 325 325 325 325 325 326 325 325 325 325 325 325 325 325 325 325 325 325 325 325 325 325 325 325 325  00
325 325 325 325 325 325 325 325 325 325 326 325 010 325 325 325 325 325 326 325 325 325 325 325 325 325 325 325 325 325 325 325 325 325 325 325 325 325  00
325 325 325 325 325 325 325 325 325 325 326 325 325 325 325 325 325 325 326 326 326 326 325 325 325 325 325 325 325 325 325 325 325 325 325 325 325 325  00
325 325 325 325 325 325 325 325 325 325 325 326 326 326 326 325 325 325 325 325 325 325 326 325 325 325 325 325 325 325 325 325 325 325 325 325 325 325  00
325 325 325 325 325 325 325 325 325 325 325 325 325 325 326 325 325 325 325 325 009 325 326 325 325 325 325 325 325 325 325 325 325 325 325 325 325 325  00
325 325 325 325 325 325 325 325 325 325 325 325 325 325 326 325 325 325 325 325 325 325 326 325 325 325 325 325 325 325 325 325 325 325 325 325 325 325  00
325 325 325 325 325 325 325 325 325 325 325 325 325 325 326 325 325 325 326 326 326 326 325 325 325 325 325 325 325 325 325 325 325 325 325 325 325 325  00
325 325 325 325 325 325 325 325 325 325 325 325 325 325 326 325 325 325 326 325 325 325 325 325 325 325 325 325 325 325 325 325 325 325 325 325 325 325  00
325 325 325 325 325 325 325 325 325 325 325 325 325 325 326 325 325 325 326 325 325 325 325 325 325 325 325 325 325 325 325 325 325 325 325 325 325 325  00
325 325 325 325 325 325 325 325 325 325 325 325 325 325 325 328 328 325 325 325 325 325 325 325 325 325 325 325 325 325 325 325 325 325 325 325 325 325  00