702
325 325 325 325 325 325 325 325 325 325 326 326 326 326 326 326 326 326 326 326 326 326 326 325 325 325 325 325 325 325 325 325 325 325 325 325 325 325 00
325 325 325 325 325 325 325 325 325 325 326 325 325 325 325 325 326 325 325 325 325 325 326 325 325 325 325 325 325 325 325 325 325 325 325 325 325 325 00
325 325 325 325 325 325 325 325 325 325 326 325 325 325 325 325 325 325 325 325 325 325 326 325 325 325 325 325 325 325 325 325 325 325 325 325 325 325 00
325 325 325 325 325 325 325 325 325 325 326 325 325 325 325 325 325 325 325 325 325 325 326 325 325 325 325 325 325 325 325 325 325 325 325 325 325 325 00
325 325 325 325 325 325 325 325 325 325 325 326 326 326 326 326 325 325 326 326 326 326 325 325 325 325 325 325 325 325 325 325 325 325 325 325 325 325 00
325 325 325 325 325 325 325 325 325 325 325 325 325 325 326 325 325 325 326 325 325 325 325 325 325 325 325 325 325 325 325 325 325 325 325 325 325 325 00
325 325 325 325 325 325 325 325 325 325 325 325 325 325 326 325 325 325 326 325 325 325 325 325 325 325 325 325 325 325 325 325 325 325 325 325 325 325 00
325 325 325 325 325 325 325 325 325 325 325 326 326 326 326 325 325 326 326 325 325 325 325 325 325 325 325 325 325 325 325 325 325 325 325 325 325 325 00
325 325 325 325 325 325 325 325 325 325 326 325 325 325 325 325 325 325 326 325 325 325 325 325 325 325 325 325 325 325 325 325 325 325 325 325 325 325 00
325 325 325 325 325 325 325 325 325 325 326 325 326 325 325 325 325 325 326 325 325 325 325 325 325 325 325 325 325 325 325 325 325 325 325 325 325 325 00
325 325 325 325 325 325 325 325 325 325 326 325 325 325 325 325 325 325 326 326 326 326 325 325 325 325 325 325 325 325 325 325 325 325 325 325 325 325 00
325 325 325 325 325 325 325 325 325 325 325 326 326 326 326 325 325 325 325 325 325 325 326 325 325 325 325 325 325 325 325 325 325 325 325 325 325 325 00
325 325 325 325 325 325 325 325 325 325 325 325 325 325 326 325 325 325 325 325 326 325 326 325 325 325 325 325 325 325 325 325 325 325 325 325 325 325 00
325 325 325 325 325 325 325 325 325 325 325 325 325 325 326 325 325 325 325 325 325 325 326 325 325 325 325 325 325 325 325 325 325 325 325 325 325 325 00
325 325 325 325 325 325 325 325 325 325 325 325 325 325 326 325 325 325 326 326 326 326 325 325 325 325 325 325 325 325 325 325 325 325 325 325 325 325 00
325 325 325 325 325 325 325 325 325 325 325 325 325 325 326 325 325 325 326 325 325 325 325 325 325 325 325 325 325 325 325 325 325 325 325 325 325 325 00
325 325 325 325 325 325 325 325 325 325 325 325 325 325 326 328 328 328 326 325 325 325 325 325 325 325 325 325 325 325 325 325 325 325 325 325 325 325 00
325 325 325 325 325 325 325 325 325 325 325 325 325 325 326 326 326 326 326 325 325 325 325 325 325 325 325 325 325 325 325 325 325 325 325 325 325 325 00