1677
 127 129 127 129 127 129 127 129 128 130 127 129 127 129 127 129 326 326 326 326 127 129 127 129 127 129 127 129 127 129 127 129 127 129 127 129 127 129 00
 128 130 128 130 128 130 128 130 127 129 128 130 128 130 128 130 325 325 325 325 128 130 128 130 128 130 128 130 128 130 128 130 128 130 128 130 128 130 00
 127 129 127 129 127 129 127 129 128 130 127 129 127 129 127 129 325 325 325 325 127 129 127 129 127 129 127 129 127 129 127 129 127 129 127 129 127 129 00
 128 130 128 130 128 130 128 130 127 129 128 130 128 130 128 130 325 325 325 325 128 130 128 130 128 130 128 130 128 130 128 130 128 130 128 130 128 130 00
 127 129 127 129 127 129 127 129 128 130 170 172 170 172 170 172 325 325 325 325 170 172 170 172 170 172 127 129 127 129 127 129 127 129 127 129 127 129 00
 128 130 128 130 128 130 128 130 127 129 159 159 159 325 325 325 325 325 325 325 325 325 325 159 159 159 128 130 128 130 128 130 128 130 128 130 128 130 00
 127 129 127 129 127 129 127 129 128 130 159 159 159 325 325 325 325 325 325 325 325 325 159 159 159 159 170 172 127 129 127 129 127 129 127 129 127 129 00
 128 130 128 130 128 130 128 130 170 172 159 159 159 325 325 325 325 325 325 325 325 325 159 159 159 159 159 159 128 130 128 130 128 130 128 130 128 130 00
 127 129 127 129 127 129 127 129 159 159 159 159 159 159 325 325 325 325 325 325 325 325 159 159 159 159 159 159 170 172 127 129 127 129 127 129 127 129 00
 128 130 128 130 128 130 128 130 159 159 159 159 159 159 325 325 325 325 325 325 325 325 159 159 159 159 159 159 159 159 128 130 128 130 128 130 128 130 00
 127 129 127 129 127 129 127 129 159 159 159 159 159 325 325 325 325 325 325 325 325 325 120 122 159 159 159 159 159 159 127 129 127 129 127 129 127 129 00
 128 130 128 130 128 130 128 130 120 122 159 159 325 325 325 325 325 325 075 075 075 075 128 130 120 122 159 159 325 325 128 130 128 130 128 130 128 130 00
 127 129 127 129 127 129 127 129 128 130 075 075 075 075 075 075 075 077 325 325 325 325 127 129 128 130 325 325 325 325 127 129 127 129 127 129 127 129 00
 128 130 128 130 128 130 128 130 127 129 325 325 325 325 325 325 325 325 325 325 325 325 128 130 170 172 325 325 325 325 128 130 128 130 128 130 128 130 00
 127 129 127 129 127 129 127 129 128 130 325 325 325 325 325 325 325 325 325 325 325 325 170 172 325 325 325 325 325 325 127 129 127 129 127 129 127 129 00
 128 130 128 130 128 130 128 130 127 129 325 325 325 325 325 325 325 325 325 325 325 325 325 325 325 325 325 325 325 325 128 130 128 130 128 130 128 130 00
 127 129 127 129 127 129 127 129 128 130 120 122 325 325 325 325 325 325 325 325 325 325 325 325 325 325 325 325 325 325 127 129 127 129 127 129 127 129 00
 128 130 128 130 128 130 128 130 127 129 128 130 325 325 325 325 325 325 325 325 325 325 325 325 325 325 325 325 325 325 128 130 128 130 128 130 128 130 00
 127 129 127 129 127 129 127 129 128 130 127 129 325 325 325 325 325 325 325 325 325 325 120 122 325 325 325 325 325 325 127 129 127 129 127 129 127 129 00
 128 130 128 130 128 130 128 130 127 129 128 130 325 325 325 325 325 325 325 325 325 325 128 130 120 122 325 325 325 325 128 130 128 130 128 130 128 130 00
 127 129 127 129 127 129 127 129 128 130 170 172 325 325 325 325 325 325 325 325 325 325 127 129 128 130 325 325 325 325 127 129 127 129 127 129 127 129 00
 128 130 128 130 128 130 128 130 170 172 159 159 325 325 325 325 325 325 325 325 325 325 128 130 127 129 325 325 325 325 128 130 128 130 128 130 128 130 00
 127 129 127 129 127 129 127 129 159 159 159 159 325 325 325 325 325 325 325 325 325 325 127 129 128 130 325 325 325 325 127 129 127 129 127 129 127 129 00
 128 130 128 130 128 130 128 130 159 159 159 159 159 159 325 325 325 325 325 325 325 325 128 130 170 172 325 325 325 325 128 130 128 130 128 130 128 130 00
 127 129 127 129 127 129 127 129 159 159 159 159 159 159 325 325 325 325 325 325 325 325 170 172 159 325 325 325 325 325 127 129 127 129 127 129 127 129 00
 128 130 128 130 128 130 128 130 159 159 159 159 159 159 325 325 325 325 163 325 159 159 159 159 159 159 325 325 325 325 128 130 128 130 128 130 128 130 00
 127 129 127 129 127 129 127 129 120 122 159 159 325 325 325 325 325 325 164 325 159 159 159 159 159 159 159 325 325 325 127 129 127 129 127 129 127 129 00
 128 130 128 130 128 130 128 130 128 130 159 159 325 325 325 325 325 325 325 325 159 159 159 159 159 159 159 325 325 325 128 130 128 130 128 130 128 130 00
 127 129 127 129 127 129 127 129 170 172 159 159 325 325 325 325 325 325 325 325 159 159 159 159 159 159 159 325 325 325 127 129 127 129 127 129 127 129 00
 128 130 128 130 128 130 128 130 159 159 159 325 325 325 325 325 325 325 325 325 159 159 159 159 159 159 159 325 325 325 128 130 128 130 128 130 128 130 00
 127 129 127 129 127 129 127 129 159 159 159 325 325 325 325 075 075 075 075 075 120 122 159 159 159 159 325 325 325 325 127 129 127 129 127 129 127 129 00
 128 130 128 130 128 130 128 130 159 159 159 325 325 325 325 325 325 325 325 325 128 130 159 159 159 325 325 325 325 325 128 130 128 130 128 130 128 130 00
 127 129 127 129 127 129 127 129 120 122 325 325 325 325 325 325 325 325 325 325 127 129 120 122 325 325 325 325 325 325 127 129 127 129 127 129 127 129 00
 128 130 128 130 128 130 128 130 128 130 325 325 325 325 325 325 325 325 325 325 128 130 128 130 325 325 325 325 325 325 128 130 128 130 128 130 128 130 00
 127 129 127 129 127 129 127 129 127 129 120 122 325 325 325 325 325 325 325 325 127 129 127 129 325 325 325 325 325 325 127 129 127 129 127 129 127 129 00
 128 130 128 130 128 130 128 130 128 130 128 130 325 325 325 325 325 325 325 325 128 130 128 130 325 325 325 325 325 325 128 130 128 130 128 130 128 130 00
 127 129 127 129 127 129 127 129 127 129 127 129 120 122 120 122 325 325 325 325 127 129 127 129 120 122 120 122 120 122 127 129 127 129 127 129 127 129 00
 128 130 128 130 128 130 128 130 128 130 128 130 128 130 128 130 325 325 325 325 128 130 128 130 128 130 128 130 128 130 128 130 128 130 128 130 128 130 00
 127 129 127 129 127 129 127 129 127 129 127 129 127 129 127 129 325 325 325 325 127 129 127 129 127 129 127 129 127 129 127 129 127 129 127 129 127 129 00
 128 130 128 130 128 130 128 130 128 130 128 130 128 130 128 130 325 325 325 325 128 130 128 130 128 130 128 130 128 130 128 130 128 130 128 130 128 130 00
 127 129 127 129 127 129 127 129 127 129 127 129 127 129 127 129 325 325 325 325 127 129 127 129 127 129 127 129 127 129 127 129 127 129 127 129 127 129 00
 128 130 128 130 128 130 128 130 128 130 128 130 128 130 128 130 325 325 325 325 128 130 128 130 128 130 128 130 128 130 128 130 128 130 128 130 128 130 00
 127 129 127 129 127 129 127 129 127 129 127 129 127 129 127 129 328 328 328 328 127 129 127 129 127 129 127 129 127 129 127 129 127 129 127 129 127 129 00






























