936

127 129  128  130  128  130  128  130  128  130  128  130  128  130  128  130  326  326  326  326  128  130  128  130  128  130  128  130  128  130  128  130  128  130  128  130  127 129 00
128 130  127  129  127  129  127  129  127  129  127  129  127  129  127  129  325  325  325  325  127  129  127  129  127  129  127  129  127  129  127  129  127  129  127  129  128 130 00
127 129  128  130  128  130  128  130  128  130  128  130  128  130  128  130  325  325  325  325  128  130  128  130  128  130  128  130  128  130  128  130  128  130  128  130  127 129 00
128 130  170  172  170  172  170  172  170  172  170  172  170  172  170  172  325  325  325  325  170  172  170  172  170  172  170  172  170  172  170  172  170  172  170  172  128 130 00
127 129  325  325  325  325  325  325  325  325  325  325  325  325  325  325  325  325  325  325  325  325  325  325  325  325  325  325  325  325  325  325  325  325  325  325  127 129 00
128 130  325  325  325  325  325  325  325  325  325  325  325  325  325  325  325  325  325  325  325  325  325  325  325  325  325  325  325  325  325  325  325  325  325  325  128 130 00
127 129  325  325  325  325  325  325  325  325  325  325  325  325  325  325  325  325  325  325  325  325  325  325  325  325  325  325  325  325  325  325  325  325  325  325  127 129 00
128 130  325  325  325  325  325  325  325  325  325  325  325  325  325  325  325  325  325  325  325  325  325  325  325  325  325  325  325  325  325  325  325  325  325  325  128 130 00
127 129  325  325  325  325  325  325  325  325  325  325  325  325  325  325  325  325  325  325  325  325  325  325  325  325  325  325  325  325  325  325  325  325  325  325  127 129 00
128 130  325  325  325  325  325  325  325  325  325  325  325  325  325  325  325  325  325  325  325  325  325  325  325  325  325  325  325  325  325  325  325  325  325  325  128 130 00
127 129  325  325  325  325  325  325  325  325  325  325  325  325  325  325  325  325  325  325  325  325  325  325  325  325  325  325  325  325  325  325  325  325  325  325  127 129 00
128 130  325  325  325  325  325  325  325  325  325  325  325  325  325  325  325  325  325  325  325  325  325  325  325  325  325  325  325  325  325  325  325  325  325  325  128 130 00
127 129  325  325  325  325  325  325  325  325  325  325  325  325  325  325  325  325  325  325  325  325  325  325  325  325  325  325  325  325  325  325  325  325  325  325  127 129 00
128 130  325  325  325  325  325  325  325  325  325  325  325  325  325  325  325  325  325  325  325  325  325  253  255  257  259  261  325  211  213  215  217  219  325  325  128 130 00
127 129  325  325  325  325  325  325  325  325  325  325  325  325  325  325  325  325  325  325  325  325  325  254  256  258  260  262  325  212  214  216  218  220  325  325  127 129 00
128 130  325  325  325  325  325  325  325  325  325  325  325  325  325  325  325  325  325  325  325  325  325  305  307  309  311  313  325  263  265  267  269  271  325  325  128 130 00
127 129  325  325  325  325  325  325  325  325  325  325  325  325  325  325  325  325  325  325  325  325  325  306  308  310  312  314  325  264  266  268  270  272  325  325  127 129 00
128 130  325  325  325  325  325  325  325  325  325  325  325  325  325  325  325  325  325  325  325  325  325  320  321  322  323  324  325  315  316  317  318  319  325  325  128 130 00
127 129  325  325  325  325  325  325  325  325  325  325  325  325  325  325  325  325  325  325  325  325  325  325  325  325  325  325  325  325  325  325  325  325  325  325  127 129 00
128 130  325  325  325  325  325  325  325  325  325  325  325  325  325  325  325  325  325  325  325  325  325  325  325  325  325  325  325  325  325  325  325  325  325  325  128 130 00
127 129  120  122  120  122  120  122  120  122  120  122  120  122  120  122  120  122  120  122  120  122  120  122  120  122  120  122  120  122  120  122  120  122  120  122  127 129 00
128 130  128  130  128  130  128  130  128  130  128  130  128  130  128  130  128  130  128  130  128  130  128  130  128  130  128  130  128  130  128  130  128  130  128  130  128 130 00
127 129  127  129  127  129  127  129  127  129  127  129  127  129  127  129  127  129  127  129  127  129  127  129  127  129  127  129  127  129  127  129  127  129  127  129  127 129 00
128 130  128  130  128  130  128  130  128  130  128  130  128  130  128  130  128  130  128  130  128  130  128  130  128  130  128  130  128  130  128  130  128  130  128  130  128 130 00
