936

327  327  327  327  327  327  327  327  327  327  327  327  327  327  327  327  327  327  327  327  327  327  327  327  327  327  327  327  327  327  327  327  327  327  327  327  327 325 00
327  327  327  327  327  327  327  327  327  327  327  327  327  327  327  327  327  327  327  327  327  327  327  327  327  327  327  327  327  327  327  327  327  327  327  327  327 325 00
327  327  327  327  327  327  327  327  327  327  327  327  327  327  327  327  327  327  327  327  327  327  327  327  327  327  327  327  327  327  327  327  327  327  327  327  327 325 00
327  327  327  327  327  327  327  327  327  327  327  327  327  327  327  327  063  063  063  063  327  327  327  327  327  327  327  327  327  327  327  327  327  327  327  327  327 325 00
327  062  064  064  064  064  064  064  064  064  064  064  064  064  064  064  064  064  064  064  064  064  064  064  064  064  064  064  064  064  064  064  064  064  064  066   327 325 00
327  062  064  008  117  117  117  117  117  117  117  117  117  117  117  117  117  117  117  117  117  117  117  117  117  117  117  117  117  117  117  117  117  006  064  066  327 325 00
327  062  064  066  327  327  327  327  327  327  327  327  327  327  327  327  327  327  327  327  327  327  327  327  327  327  327  327  327  327  327  327  327  062  064  066  327 325 00
327  062  064  066  327  327  327  327  327  327  327  327  327  327  327  327  327  327  327  327  327  327  327  327  327  327  327  327  327  327  327  327  327  062  064  066  327 325 00
327  062  064  066  327  327  327  327  327  327  327  327  327  327  327  327  327  327  327  327  327  327  327  327  327  327  327  327  327  327  327  327  327  062  064  066  327 325 00
327  062  064  066  327  327  327  327  327  327  327  327  327  327  327  327  327  327  327  327  327  327  327  327  327  327  327  327  327  327  327  327  327  062  064  066  327 325 00
327  062  064  066  327  327  327  327  327  327  327  327  327  327  327  327  327  327  327  327  327  327  327  327  327  327  327  327  327  327  327  327  327  062  064  066  327 325 00
327  062  064  066  327  327  327  327  327  327  327  327  327  327  327  327  327  327  327  327  327  327  327  327  327  327  327  327  327  327  327  327  327  062  064  066  327 325 00
327  062  064  066  327  327  327  327  327  327  327  327  327  327  327  327  327  327  327  327  327  327  327  327  327  327  327  327  327  327  327  327  327  062  064  066  327 325 00
327  062  064  066  327  327  327  327  327  327  327  327  327  327  327  327  327  327  327  327  327  327  327  327  327  327  327  327  327  327  327  327  327  062  064  066  327 325 00
327  062  064  066  327  327  327  327  327  327  327  327  327  327  327  327  327  327  327  327  327  327  327  327  327  327  327  327  327  327  327  327  327  062  064  066  327 325 00
327  062  064  066  327  327  327  327  327  327  327  327  327  327  327  327  327  327  327  327  327  327  327  327  327  327  327  327  327  327  327  327  327  062  064  066  327 325 00
327  062  064  066  327  327  327  327  327  327  327  327  327  327  327  327  327  327  327  327  327  327  327  327  327  327  327  327  327  327  327  327  327  062  064  066  327 325 00
327  062  064  066  327  327  327  327  327  327  327  327  327  327  327  327  327  327  327  327  327  327  327  327  327  327  327  327  327  327  327  063  327  062  064  066  327 325 00
327  062  064  007  063  063  063  063  063  063  063  063  063  063  063  063  063  063  063  063  063  063  063  063  063  063  063  063  063  063  063  063  063  005  064  066  327 325 00
327  062  064  064  064  064  064  064  064  064  064  064  064  064  064  064  064  064  064  064  064  064  064  064  064  064  064  064  064  064  064  064  064  064  064  066  327 325 00
327  115  117  117  117  117  117  117  117  117  117  117  117  117  117  117  117  117  117  117  117  117  117  117  117  117  117  117  117  117  117  117  117  117  117  119  327 325 00
327  327  327  327  327  327  327  327  327  327  327  327  327  327  327  327  327  327  327  327  327  327  327  327  327  327  327  327  327  327  327  327  327  327  327  327  327 325 00
327  327  327  327  327  327  327  327  327  327  327  327  327  327  327  327  327  327  327  327  327  327  327  327  327  327  327  327  327  327  327  327  327  327  327  327  327 325 00
327  327  327  327  327  327  327  327  327  327  327  327  327  327  327  327  327  327  327  327  327  327  327  327  327  327  327  327  327  327  327  327  327  327  327  327  327 325 00