624

127 129  128  130  128  130  128  130  128  130  128  130  128  130  128  130  128  130  326  326  326  326  128  130  128  130  128  130  128  130  128  130  128  130  128  130  127 129 00
128 130  127  129  127  129  127  129  127  129  127  129  127  129  127  129  127  129  325  325  325  325  127  129  127  129  127  129  127  129  127  129  127  129  127  129  128 130 00
127 129  128  130  128  130  128  130  128  130  128  130  128  130  128  130  128  130  325  325  325  325  128  130  128  130  128  130  128  130  128  130  128  130  128  130  127 129 00
128 130  170  172  170  172  170  172  170  172  170  172  170  172  170  172  170  172  325  325  325  325  170  172  170  172  170  172  170  172  170  172  170  172  170  172  128 130 00
127 129  325  325  325  221  223  225  227  221  223  225  227  221  223  225  227  325  325  325  325  325  325  325  221  223  225  227  221  223  225  227  221  223  225  227  127 129 00
128 130  325  325  325  222  224  226  228  222  224  226  228  222  224  226  228  325  325  325  325  325  325  325  222  224  226  228  222  224  226  228  222  224  226  228  128 130 00
127 129  325  325  325  273  275  277  279  273  275  277  279  273  275  277  279  325  325  325  325  325  325  325  273  275  277  279  273  275  277  279  273  275  277  279  127 129 00
128 130  325  325  325  274  276  278  280  274  276  278  280  274  276  278  280  325  325  325  325  325  325  325  274  276  278  280  274  276  278  280  274  276  278  280  128 130 00
127 129  325  325  325  325  325  325  325  325  325  325  325  325  325  325  325  325  325  325  325  325  325  325  325  325  325  325  325  325  325  325  325  325  325  325  127 129 00
128 130  325  325  325  221  223  225  227  325  325  325  325  325  325  325  325  221  223  225  227  325  325  325  325  325  325  325  325  325  325  325  221  223  225  227  128 130 00
127 129  325  325  325  222  224  226  228  325  325  325  325  325  325  325  325  222  224  226  228  325  325  325  325  325  325  325  325  325  325  325  222  224  226  228  127 129 00
128 130  325  325  325  273  275  277  279  325  325  325  325  325  325  325  325  273  275  277  279  325  325  325  325  325  325  325  325  325  325  325  273  275  277  279  128 130 00
127 129  325  325  325  274  276  278  280  325  325  325  325  325  325  325  325  274  276  278  280  325  325  325  325  325  325  325  325  325  325  325  274  276  278  280  127 129 00
128 130  120  122  120  122  120  122  120  122  120  122  120  122  120  122  120  122  120  122  120  122  120  122  120  122  120  122  120  122  120  122  120  122  120  122  128 130 00
127 129  128  130  128  130  128  130  128  130  128  130  128  130  128  130  128  130  128  130  128  130  128  130  128  130  128  130  128  130  128  130  128  130  128  130  127 129 00
128 130  127  129  127  129  127  129  127  129  127  129  127  129  127  129  127  129  127  129  127  129  127  129  127  129  127  129  127  129  127  129  127  129  127  129  128 130 00